6 B 5 E
WWWWWW
W___PW
WU_P_W
W_G__W
W__P_W
WWWWWW
